-size
height: 28
width: 19

-player
spawn: 13.0000 14.0000

-entities
ghast: 1.9343 22.8254
medikit: 17.4375 17.4361
medikit: 16.3391 17.4683
medikit: 9.5230 10.5552
medikit: 10.5890 10.5229
nyarlathotep: 2.1557 7.3587
ammo: 17.2465 5.3621
ammo: 17.3052 3.6006
pistol: 15.6258 13.9415

-map
: 4444444444444444444
: 4                 4
: 4                 4
: 4   0             4
: 4   0             4
: 4   0             4
: 4   0             4
: 4   0             4
: 4   0             4
: 4444444455555B85555
:         5         5
:         5        15
:         51        5
:         5        C5
:         5         5
:         5        15
:         5         5
:         5 1       5
: 2222222255555965555
: 2                 2
: 2      1          2
: 2  1              2
: 2                 2
: 2          1      2
: 2    1            2
: 2 1               2
: 2                 2
: 2222222222222222222

